0
@@@@@@@@@@@@@@@@@@@@@@
@LLLLLLLLLLLLLLLLLFLL@
@LRRRLRRRLRRRLRRRLRLL@
@LRLRLRLRLRLRLRLRLRLL@
@LRLRLRLRLRLRLRLRLRLL@
@LRLRLRLRLRLRLRLRLRLL@
@LRLRLRLRLRLRLRLRLRLL@
@LRLRLRLRLRLRLRLRLRLL@
@LRLRLRLRLRLRLRLRLRLL@
@LRLRLRLRLRLRLRLRLRLL@
@LRLRLRLRLRLRLRLRLRLL@
@LRLRLRLRLRLRLRLRLRLL@
@LRLRLRLRLRLRLRLRLRLL@
@LRLRLRLRLRLRLRLRLRLL@
@LRLRLRLRLRLRLRLRLRLL@
@LRLRLRLRLRLRLRLRLRLL@
@LRLRLRLRLRLRLRLRLRLL@
@LRLRLRLRLRLRLRLRLRLL@
@LRLRLRLRLRLRLRLRLRLL@
@LRLRRRLRRRLRRRLRRRLL@
@LSLLLLLLLLLLLLLLLLLL@
@@@@@@@@@@@@@@@@@@@@@@
1
@@@@@@@@@@@@@@@@@@@@@@
@LLLLLLLLLLLLLLLLLLLL@
@LRRRRRRRLRRRRRRRLRRR@
@LRLLLLLRLRLLLLLRLRLR@
@LRLRRRLRLRLRRRLRLRLR@
@LRLRLRLRLRLRLRLRLRLR@
@LRLRLRLRLRLRLRLRLRLR@
@LRLRLRLRLRLRLRLRLRLR@
@LRLRLRLRLRLRLRLRLRLR@
@LRLRLRLRLRLRLRLRLRLR@
@LRLRLRLRLRLRLRLRLRLR@
@LRLRLRLRLRLRLRLRLRLR@
@LRLRLRLRLRLRLRLRLRLR@
@LRLRLRLRLRLRLRLRLRLR@
@LRLRLRLRLRLRLRLRLRLR@
@LRLRLRLRLRLRLRLRLRLR@
@LRLRLRLRLRLRLRLRLRLR@
@LRLRLRLRRRLRLRLRRRLR@
@LRLRLRLLLLLRLRLLLLLR@
@LRLRLRRRRRRRLRRRRRRR@
@LSLFLLLLLLLLLLLLLLLL@
@@@@@@@@@@@@@@@@@@@@@@
2
@@@@@@@@@@@@@@@@@@@@@@
@LLLLLLLLLLLLLLLLLLLL@
@LRRRRRRRRRRRRRRRRRRL@
@LRLLLLLLLLLLLLLLLLRL@
@LRLRRRRRRLLRRRRRRLRL@
@LRLRLLLLRLLRLLLLRLRL@
@LRLRLLSLRLLRLFLLRLRL@
@LRLRLLRLRLLRLRLLRLRL@
@LRLRLLRLRLLRLRLLRLRL@
@LRLRLLRLRLLRLRLLRLRL@
@LRLRLLRLRLLRLRLLRLRL@
@LRLRLLRLRLLRLRLLRLRL@
@LRLRLLRLRLLRLRLLRLRL@
@LRLRLLRLRLLRLRLLRLRL@
@LRLRLLRLRLLRLRLLRLRL@
@LRLRLLRLRLLRLRLLRLRL@
@LRLRLLRLRLLRLRLLRLRL@
@LRLRRRRLRLLRLRRRRLRL@
@LRLLLLLLRLLRLLLLLLRL@
@LRRRRRRRRLLRRRRRRRRL@
@LLLLLLLLLLLLLLLLLLLL@
@@@@@@@@@@@@@@@@@@@@@@
3
@@@@@@@@@@@@@@@@@@@@@@
@LLLLLLLLLLLLLLLLLLLL@
@LRRRRRRRRRRRRRRRRRRL@
@LRLLLLLLLLLLLLLLLLRL@
@LRLRRRRRRRRRRRRRRLRL@
@LRLRLLLLLLLLLLLLRLRL@
@LRLRLRRRRRRRRRRLRLRL@
@LRLRLRLLLLLLLLRLRLRL@
@LRLRLRLRRRRRRLRLRLRL@
@LRLRLRLRLLLLRLRLRLRL@
@LRLRLRLRLSLLRLRLRLRL@
@LRLRLRLRLRLLRLRLRLRL@
@LRLRLRLRLRLLRLRLRLRL@
@LRLRLRLRLRRRRLRLRLRL@
@LRLRLRLRLLLLLLRLRLRL@
@LRLRLRLRRRRRRRRLRLRL@
@LRLRLRLLLLLLLLLLRLRL@
@LRLRLRRRRRRRRRRRRLRL@
@LRLRLLLLLLLLLLLLLLRL@
@LRLRRRRRRRRRRRRRRRRL@
@LFLLLLLLLLLLLLLLLLLL@
@@@@@@@@@@@@@@@@@@@@@@
4
@@@@@@@@@@@@@@@@@@@@@@
@LLLLLLLLLLLLLLLLLLLL@
@SRLRRRLRRRLRRRLRRRLL@
@LRLRLRLRLRLRLRLRLRLL@
@LRRRLRRRLRRRLRRRLRLL@
@LLLLLLLLLLLLLLLLLRLL@
@LRRRLRRRLRRRLRRRLRLL@
@LRLRLRLRLRLRLRLRLRLL@
@LRLRRRLRRRLRRRLRRRLL@
@LRLLLLLLLLLLLLLLLLLL@
@LRLRRRLRRRLRRRLRRRLL@
@LRLRLRLRLRLRLRLRLRLL@
@LRRRLRRRLRRRLRRRLRLL@
@LLLLLLLLLLLLLLLLLRLL@
@LRRRLRRRLRRRLRRRLRLL@
@LRLRLRLRLRLRLRLRLRLL@
@LRLRRRLRRRLRRRLRRRLL@
@LRLLLLLLLLLLLLLLLLLL@
@LRLRRRLRRRLRRRLRRRLL@
@LRLRLRLRLRLRLRLRLRLL@
@LRRRLRRRLRRRLRRRLFLL@
@@@@@@@@@@@@@@@@@@@@@@
5
@@@@@@@@@@@@@@@@@@@@@@
@LLLLLLLLLLLLLLLLLLLL@
@LRRRLLLLLLLLLLLLRRRL@
@LRLRRLLLLLLLLLLRRLRL@
@LRLLRRLLLLLLLLRRLLRL@
@LRLLLRLLLLLLLLRLLLRL@
@LRLLLRLLLLLLLLRLLLRL@
@LRLLLRRLLLLLLRRLLLRL@
@LRLLLLRLLLLLLRLLLLRL@
@LRLLLLRRLLLLRRLLLLRL@
@LRLLLLLRRLLRRLLLLLRL@
@LRLLLLLLRRRRLLLLLLRL@
@LRLRRRLLLLLLLLRRRLRL@
@LRLRLRRLLLLLLRRLRLRL@
@LRLRLLRRLLLLRRLLRLRL@
@LRLRLLLRRLLRRLLLRLRL@
@LRLRLLLLRRRRLLLLRLRL@
@LRLRLLLLLLLLLLLLRLRL@
@LRLRLLLLLLLLLLLLRLRL@
@LRRRLLLLLLLLLLLLRLRL@
@LLLLLLLLLLLLLLLLSLFL@
@@@@@@@@@@@@@@@@@@@@@@
6
@@@@@@@@@@@@@@@@@@@@@@
@LLLLLLLLLLLLLLLLLLLL@
@LLLRRRRLLRRRRRRRRRLL@
@LLLRLLRLLRLLLLLLLRLL@
@SRRRLLRRRRLLLLLLLRLL@
@LLLLLLLLLLLLLLLLLRLL@
@LLLLLLLLLLLLLLLLLRLL@
@LLLLLLLLLLLLLLLLLRLL@
@LLLLRRRRRRRRRRRRRRLL@
@LLLLRLLLLLLLLLLLLLLL@
@LLLLRLLLLLLLLLLLLLLL@
@LLLLRRRRRRLLLLLLLLLL@
@LLLLLLLLLRLLLLLLLLLL@
@LLLLLLLLLRLLLLLLLLLL@
@LLLLLLLLLRLLLLLLLLLL@
@LLLLRRRRRRLLLLLLLLLL@
@LLLLRLLLLLLLLLLLLLLL@
@LLLLRLLLLLLLLLLLLLLL@
@LLLLRRRRRRRRRRRRRRLL@
@LLLLLLLLLLLLLLLLLRLL@
@LLLLLLLLLLLLLLLLLFLL@
@@@@@@@@@@@@@@@@@@@@@@
7
@@@@@@@@@@@@@@@@@@@@@@
@LLLLLLLLLLLLLLLLLLLL@
@LLLLLRRRRRRRRRRLLLLL@
@LLLLRRLLLLLLLLRRLLLL@
@LLLRRLLLLLLLLLLRRLLL@
@LLRRLLLLLLLLLLLLRRLL@
@LRRLLLLLLLLLLLLLLRRL@
@LRLLLLLLLLLLLLLLLLRL@
@LRLLLLLLLLLLLLLLLLRL@
@LRLLLLLLLLLLLLLLLLRL@
@LRLLLLLLLLLLLLLLLLRL@
@LRRLLLLLLLLLLLLLLRRL@
@LLRRLLLLLLLLLLLLRRLL@
@LLLRRLLLLLLLLLLRRLLL@
@LLLLRRLLLLLLLLRRLLLL@
@LLLLLRRLLLLLLRRLLLLL@
@LLLLLLRRLLLLRRLLLLLL@
@LLLLLLLRLLLLRLLLLLLL@
@LLLLLLLRLLLLRLLLLLLL@
@SRRRRRRRLLLLRRRRRRRF@
@LLLLLLLLLLLLLLLLLLLL@
@@@@@@@@@@@@@@@@@@@@@@
8
@@@@@@@@@@@@@@@@@@@@@@
@LLLLLLLLLLLLLLLLLLLL@
@LRRRRRRRRLLRRRRRRRRL@
@LRLLLLLLRLLRLLLLLLRL@
@LRLLLLLLRLLRLLLLLLRL@
@LRLLLLLLRLLRLLLLLLRL@
@LRRRRLLLRRRRLLLRRRRL@
@LLLLRLLLLLLLLLLRLLLL@
@LLLLRLLLLLLLLLLRLLLL@
@SRRRRLLLLLLLLLLRLLLL@
@LLLLLLLLLLLLLLLRLLLL@
@LLLLLLLLLLLLLLLRLLLL@
@FRRRRLLLLLLLLLLRLLLL@
@LLLLRLLLLLLLLLLRLLLL@
@LLLLRLLLLLLLLLLRLLLL@
@LRRRRLLLRRRRLLLRRRRL@
@LRLLLLLLRLLRLLLLLLRL@
@LRLLLLLLRLLRLLLLLLRL@
@LRLLLLLLRLLRLLLLLLRL@
@LRRRRRRRRLLRRRRRRRRL@
@LLLLLLLLLLLLLLLLLLLL@
@@@@@@@@@@@@@@@@@@@@@@
9
@@@@@@@@@@@@@@@@@@@@@@
@LLLLLLLLLLLLLLLLLLLL@
@LLLRRRRRRRRRRRRRRRRL@
@LLRRLLLLLLLLLLLLLLRL@
@LLRLLLLLLLLLLLLLLRRL@
@LLRLLLLLLLLLLLLLRRLL@
@LLRLLLLLLLLLLLLLRLLL@
@LLRLLLLLLLLLLLLRRLLL@
@LLRLLLLLLLLLLLRRLLLL@
@LLRLLLLLLLLLLRRLLLLL@
@LLRLLLLLLLLLRRLLLLLL@
@LLRLLLLLLLLLRLLLLLLL@
@LLRLLLLLLLLLRLLLLLLL@
@LLRLLLLLLLLLRRLLLLLL@
@LLRLLLLLLLLLLRRLLLLL@
@LLRLLLLLLLLLLLRRLLLL@
@LLRLLLLLLLLLLLLRRLLL@
@LLRLLLLLLLLLLLLLRRLL@
@LLRLLLLLLLLLLLLLLRLL@
@LLRLLLLLLLLLLLLLLRLL@
@LLSLLLLLLLLLLLLLLFLL@
@@@@@@@@@@@@@@@@@@@@@@

