@@@@@@@@@@@@@@@@@@@@@@
@LLLLLLLLLLLLLLLLLFLL@
@LRRRLRRRLRRRLRRRLRLL@
@LRLRLRLRLRLRLRLRLRLL@
@LRLRLRLRLRLRLRLRLRLL@
@LRLRLRLRLRLRLRLRLRLL@
@LRLRLRLRLRLRLRLRLRLL@
@LRLRLRLRLRLRLRLRLRLL@
@LRLRLRLRLRLRLRLRLRLL@
@LRLRLRLRLRLRLRLRLRLL@
@LRLRLRLRLRLRLRLRLRLL@
@LRLRLRLRLRLRLRLRLRLL@
@LRLRLRLRLRLRLRLRLRLL@
@LRLRLRLRLRLRLRLRLRLL@
@LRLRLRLRLRLRLRLRLRLL@
@LRLRLRLRLRLRLRLRLRLL@
@LRLRLRLRLRLRLRLRLRLL@
@LRLRLRLRLRLRLRLRLRLL@
@LRLRLRLRLRLRLRLRLRLL@
@LRLRRRLRRRLRRRLRRRLL@
@LSLLLLLLLLLLLLLLLLLL@
@@@@@@@@@@@@@@@@@@@@@@
0
